9 9
22
12 15 7 19 1 12 18 1 4 
19 20 1 11 20 14 20 16 10 
7 2 0 7 1 9 4 17 19 
6 14 19 12 17 1 14 12 6 
0 18 0 15 0 1 7 15 6 
10 7 0 5 19 11 15 18 10 
15 0 0 20 18 16 6 2 12 
16 7 0 0 15 14 4 7 7 
13 0 10 2 13 16 14 12 248 
