8 7
21
8 9 5 12 2 8 4 
0 2 3 12 11 7 12 
2 9 10 7 12 12 5 
2 0 5 2 3 9 6 
11 11 0 5 5 7 9 
9 12 8 11 2 8 10 
5 11 10 2 4 2 8 
9 4 0 6 5 5 153 
