6 8
22
6 7 4 9 1 6 8 5 
1 0 2 0 9 0 9 9 
1 6 8 5 4 1 9 2 
4 1 4 8 9 6 3 3 
0 0 5 7 8 3 6 9 
0 6 1 6 3 4 6 118 
